77777777777777777777
66666666666666666666
55555555555555555555
44444444444444444444
33333333333333333333
22222222222222222222
11111111111111111111
33333333333333333333
22222222222222222222
11111111111111111111
33333333333333333333
22222222222222222222
11111111111111111111
33333333333333333333
22222222222222222222
11111111111111111111
33333333333333333333
22222222222222222222
11111111111111111111
00000000000000000000