00000000000000000000
00000000000000000000
00000000000000000000
00000000000000000000
01111111111111111110
01222222222222222210
01222222222222222210
01222222222222222210
01111111111111111110
00000000000000000000
00000000000000000000
00000000000000000000
00000000000000000000
00000000000000000000
00000000000000000000
00000000000000000000
00000000000000000000
00000000000000000000
00000000000000000000
00000000000000000000