00000000000000000000
03133333133133333130
01000000100100000010
03133333133133333130
01000000100100000010
03133333133133333130
01000000100100000010
03133333133133333130
01000000100100000010
03133333133133333130
01000000100100000010
03133333133133333130
01000000100100000010
03133333133133333130
01000000100100000010
03133333133133333130
01000000100100000010
03133333133133333130
00000000000000000000
22222222222222222222